$$$ exec p1 : [./rpoetess.filler]
Plateau 15 17:
    01234567890123456
000 .................
001 .................
002 .................
003 .................
004 .................
005 .................
006 .......OOXxx.....
007 .......OXXXXX....
008 ..OOOOOOOXXXX....
009 ...O.OOOOOOXXX...
010 ....OOOOOOOXXX...
011 .......OOOOX.X...
012 ........OO...XX..
013 .................
014 .................
Piece 2 1:
*
*